{
  "name": "map1",
  "coords": [
    [14,14,14,14,14,14,14,14,14,14],
    [14,14,14,14,1,14,14,14,14,14],
    [14,14,14,14,14,14,14,14,14,14],
    [14,14,1,14,14,14,2,14,14,14],
    [14,14,14,14,14,14,3,14,14,14],
    [14,14,14,1,14,14,14,14,1,14],
    [14,14,14,4,14,6,14,14,14,14],
    [14,1,14,14,14,14,14,14,14,14],
    [14,14,14,5,14,14,14,14,14,14],
    [14,14,14,14,14,14,14,14,14,14]
  ],
  "terrain_types": {
    "walk": [14],
    "wall": [1, 2, 3, 4, 5, 6]
  },
  "min_players": 2,
  "max_players": 4
}
