{
  "name": "map1",
  "coords": [
    [14,14,14,14,1,14,14,14,14,14],
    [14,14,14,14,14,14,14,14,14,14],
    [14,14,14,14,14,14,14,14,14,14],
    [14,14,1,14,14,14,1,14,14,14],
    [14,14,14,14,14,14,1,14,14,14],
    [14,14,14,1,14,14,14,14,14,1],
    [14,14,14,1,14,1,14,14,14,14],
    [1,14,14,14,14,14,14,14,14,14],
    [14,14,14,14,14,14,14,14,14,14],
    [14,14,14,1,14,14,14,14,14,14]
  ],
  "terrain_types": {
    "walk": [14],
    "wall": [1]
  },
  "max_players": 2
}
