{
  "name": "map2",
  "coords": [
    [14,14,14,14,14,14,14,14,14,14],
    [14,14,14,14,14,1,14,14,14,14],
    [14,1,14,14,14,14,14,14,14,14],
    [14,14,101,102,103,104,1,14,14,14],
    [14,14,105,106,107,108,1,14,14,14],
    [14,14,109,110,111,112,14,14,1,14],
    [14,14,113,114,115,116,14,14,14,14],
    [14,14,14,14,14,14,14,14,14,14],
    [14,14,14,1,14,14,14,14,14,14],
    [14,14,14,14,14,14,14,14,14,14]
  ],
  "terrain_types": {
    "walk": [14],
    "wall": [1, 101, 102, 103, 104, 105, 106, 107, 108, 109, 110, 111, 112, 113, 114, 115, 116]
  },
  "min_players": 2,
  "max_players": 4
}
